L,6,7
H,0
W,2,3,3,3
W,3,3,4,3
W,4,3,5,4
W,5,4,6,4
W,6,4,6,3
W,6,3,7,3
W,7,3,8,3
W,8,3,8,4
W,8,4,9,4
W,9,4,9,5
W,9,5,8,6
W,8,6,9,7
W,9,7,8,8
W,8,8,7,9
W,7,9,6,9
W,5,9,6,9
W,5,9,4,8
W,4,8,5,7
W,5,7,6,6
W,6,6,6,5
W,6,5,5,5
W,5,5,4,6
W,4,6,3,7
W,3,7,2,7
W,2,7,1,6
W,1,6,1,5
W,1,5,1,4
W,1,4,1,3
W,1,3,2,3
S,2,5,R,G,G
S,4,4,G,R,R
S,7,4,G,G,R
S,8,5,R,G,R
S,7,8,G,R,G